E********
*       *
*       *
*   *****
*   *****
**      *
*   S   *
*       *
*********
